R 800 600
NO ./texture/CROSSCUBE.xpm
SO ./texture/CROSSCUBE.xpm
WE ./texture/CROSSCUBE.xpm
EA ./texture/CROSSCUBE.xpm

S ./texture/ani_sprite/oilbarrel0.xpm

F 111,111,111
C 50,50,50


11111111111111111111111
10000202020200000000001
100E0000000020000000001
10010020000200000000001
11111111101100000111111
100000000011000011
11110111111111011
11110111111111011
11000000110101011
100020000002000011
100000000000000011
101011110000000111
1111011111110101
11111111 1111111
