R 1280 720
NO ./path_to_the_north_texture
SO ./path_to_the_south_texture
WE ./path_to_the_west_texture
EA ./path_to_the_east_texture

S ./path_to_the_sprite_texture
F 220,100,0
C 225,30,0

11111111111111111
1W0000001000100001
100000001000100001
100100201000100001
11111111101100001
100000000011000011
11110111111111011
11110111111111011
11000000110101011
100020000002000011
100000000000000011
101011110000000111
1111011111110101
11111111 1111111