R 4000 3000
NO ./texture/bluestone.xpm
SO ./texture/colorstone.xpm
WE ./texture/mossy.xpm
EA ./texture/redbrick.xpm

S ./texture/barrel.xpm

C 10,255,255
F 10,200,10


11111111111111111
10000000020200001
10000000000020001
10010020000200001
11111111101100001
100000000011000011
11110111111111011
11110111111111011
11000000110101E11
100020000002000011
100000000000000011
101011110000000111
1111011111110101
11111111 1111111
