R 1280 720
NO ./texture/test_e.xpm
SO ./texture/test_e.xpm
WE ./texture/test_e.xpm
EA ./texture/test_e.xpm

S ./texture/floor.xpm

F 111,111,111
C 50,50,50


11111111111111111
1W000000020000001
10000000000000001
10010020000000001
11111111101100001
100000000011000011
11110111111111011
11110111111111011
11000000110101011
100020000002000011
100000000000000011
101011110000000111
1111011111110101
11111111 1111111
