R 1280 720
NO ./texture/test_n.xpm
SO ./texture/test_n.xpm
WE ./texture/test_n.xpm
EA ./texture/test_n.xpm

S ./texture/floor2.xpm
F 111,111,111
C 50,50,50

        1111111111111111111111111
        1000000000110000000000001
        1011000001110000002000001
        1001002000000000000000001
111111111011000001110000000000001
100000000011000001110111111111111
11110111111111011100000010001
11110111111111011101010010001
11000000110101011100000010001
10002000000200001100000000001
10000000000000001101010010001
11002001110101011101011110N0111
11110111 1110101 101111210001
11111111 1111111 111111111111